particulate: hạt
matter: chất , vật chất
indicating: chỉ ra
death: chết
dying sấp chết
outpace: vượt xa
drags: kéo
heels: gót chân
coal: than đá
mines: mỏ
the head: người đứng đầu
ever-growing: ngày càng phát triển
worse: tệ hơn
coal-fired: đốt than 
laggard (n) tụt hậu
behind: đằng sau
stringent: nghiêm khắc

emission khí thải
annual: hằng năm
 power sector: ngành điện
launched: ra mắt
ramring: tăng tốc
election : cuộc bầu cử
population: dân số
industries: các ngành nghề
previously: trước đó
renewable : tái tạo
prodution:sản xuất
enery: năng lượng
serious: nghiêm trọng 
pollution: Sự ô nhiễm
Secretary : thư kí
swarup: trao đôi
immediately: ngay lập tức
respond: trả lời
uprooted : bật gốc, chặt bỏ
wished away: bỏ đi
aims: mục đích
approximately: khoảng
annual: hằng năm
attitude : thái độ
towards : đối với
disappointed : thất vọng